关关雎鸠	在河之洲						
窈窕淑女	君子好逑						
他山之石	可以攻玉						
言者无罪	闻者足戒						
老骥伏枥	志在千里						
烈士暮年	壮心不已。						
捐躯赴国难	视死忽如归						
山不厌高	水不厌深						
周公吐哺	天下归心						
蜀道之难	难于上青天						
万里赴戎机	关山度若飞						
何以解忧	唯有杜康						
刑天舞干戚	猛志固常在						
采菊东篱下	悠然见南山						
晨兴理荒秽	戴月荷锄归						
奇文共欣赏	疑义相与析						
及时宜自勉	岁月不待人						
山随平野近	江入大荒流						
清水出芙蓉	天然去雕饰						
读书破万卷	下笔如有神						
笔落惊风雨	诗成泣鬼神						
前不见古人	后不见来者						
谁言寸草心	报得三春晖						
青山遮不住	毕竟东流去						
海上生明月	天涯共此时						
野旷天低树	江清月近人						
感时花溅泪	恨别鸟惊心						
烽火连三月	家书抵万金						
岱宗夫如何	齐鲁青未了						
造化钟神秀	阴阳割昏晓						
荡胸生层云	决眦入归鸟						
会当凌绝顶	一览众山小						
星垂平野阔	月涌大江流						
朱门酒肉臭	路有冻死骨						
露从今夜白	月是故乡明						
野火烧不尽	春风吹又生						
大漠孤烟直	长河落日圆						
明月松间照	清泉石上流						
竹喧归浣女	莲动下渔舟						
随意春芳歇	王孙自可留						
两句三年得	一吟双泪流						
少壮不努力	老大徒伤悲						
莫道桑榆晚	为霞尚满天						
本是同根生	相煎何太急						
鸟宿池边树	僧敲月下门						
无意苦争春	一任群芳妒						
江流天地外	山色有无中						
蝉噪林愈静	鸟呜山更幽						
羁鸟恋旧林	池鱼思故渊						
夕阳无限好	只是近黄昏						
生当作人杰	死亦为鬼雄						
气蒸云梦泽	波撼岳阳城						
疾风知劲草	板荡识忠臣						
人生自古谁无死	留取丹心照汗青						
枝上柳绵吹又少	天涯何处无芳草						
东边日出西边雨	道是无晴却有晴						
衣带渐宽终不悔	为伊消得人憔悴						
在天愿作比翼鸟	在地愿为连理枝						
天长地久有时尽	此恨绵绵无绝期						
日出江花红胜火	春来江水绿如蓝						
溪云初起日沉阁	山雨欲来风满楼						
尔曹身与名俱灭	不废江河万古流						
长风破浪会有时	直挂云帆济沧海						
凤凰台上凤凰游	凤去台空江自流						
三山半落青天外	二水中分白露洲						
吴宫花草埋幽径	晋代衣冠成古丘						
总为浮云能蔽日	长安不见使人愁						
花开堪折直须折	莫待无花空折枝						
我劝天公重抖擞	不拘一格降人才						
云横秦岭家何在	雪拥蓝关马不前						
千呼万唤始出来	犹抱琵琵半遮面						
江山代有才人出	各领风骚数百年						
但使龙城飞将在	不教胡马度阴山						
我自横刀向天笑	去留肝胆两昆仑						
近水楼台先得月	向阳花木易逢春						
抽刀断水水更流	举杯消愁愁更愁						
出师未捷身先死	常使英雄泪满襟						
无边落木萧萧下	不尽长江滚滚来						
回眸一笑百媚生	六宫粉黛无颜色						
独在异乡为异客	每逢佳节倍思亲						
身无彩凤双飞翼	心有灵犀一点通						
何当共剪西窗烛	却话巴山夜雨时						
春蚕到死丝方尽	蜡炬成灰泪始干						
报君黄金台上意	提携玉龙为君死						
旧时王谢堂前燕	飞入寻常百姓家						
沉舟侧畔千帆过	病树前头万木春						
商女不知亡国恨	隔江犹唱后庭花						
春风又绿江南岸	明月何时照我还						
春风得意马蹄疾	一日看尽长安花						
春色满园关不住	一枝红杏出墙来						
春江潮水连海平	海上明月共潮生						
滟滟随波千万里	何处春江无月明						
春城无处不飞花	寒食东风御柳斜						
日暮汉宫传蜡烛	轻烟散入五侯家						
春潮带雨晚来急	野渡无人舟自横						
相见时难别亦难	东风无力百花残						
举世皆浊我独清	众人皆醉我独醒						
洛阳亲友如相问	一片冰心在玉壶						
粉身碎骨浑不怕	要留青白在人间						
战士军前半死生	美人帐下犹歌舞						
莫怪春来便归去	江南虽好是他乡						
借问酒家何处有	牧童遥指杏花村						
东风不与周郎便	铜雀春深锁二乔						
浊酒一杯家万里	燕然未勒归无计						
春宵一刻值千金	花有清香月有阴						
月落乌啼霜满天	江枫渔火对愁眠						
姑苏城外寒山寺	夜半钟声到客船						
沾衣欲湿杏花雨	吹面不寒杨柳风						
.问渠哪得清如许	为有源头活水来						
两情若是久长时	又岂在朝朝暮暮						
纸上得来终觉浅	绝知此事要躬行						
接天莲叶无穷碧	映日荷花别样红						
着意栽花花不发	无心插柳柳成阴						
等闲识得东风面	万紫千红总是春						
莫愁前路无知己	天下谁人不识君						
梅须逊雪三分白	雪却输梅一段香						
绿杨烟外晓寒轻	红杏枝头春意闹						
欲把西湖比西子	浓装淡抹总相宜						
欲寄彩笺兼尺素	山长水阔知何处						
黄沙百战穿金甲	不破楼兰终不还						
曾经沧海难为水	除却巫山不是云						
疏影横斜水清浅	暗香浮动月黄昏						
落霞与孤鹜齐飞	秋水共长天一色						
横看成岭侧成峰	远近高低各不同						
不识庐山真面目	只缘身在此山中						
僵卧孤村不自哀	尚思为国戌轮台						
夜阑卧听风吹雨	铁马冰河入梦来						
千里莺啼绿映红	水村山廓酒旗风						
南朝四百八十寺	多少楼台烟雨中						
王师北定中原日	家祭无忘告乃翁						
遗民泪尽胡尘里	南望王师又一年						
九州生气恃风雷	万马齐喑究可哀						
三十功名尘与土	八千里路云和月						
壮志饥餐胡虏肉	笑谈渴饮匈奴血						
万里悲秋常作客	百年多病独登台						
上穷碧落下黄泉	两处茫茫皆不见						
山重水复疑无路	柳暗花明又一村						
无可奈何花落去	似曾相识燕归来						
千门万户瞳瞳日	总把新桃换旧符						
不要人夸颜色好	只留清气满乾坤						
咬定青山不放松	立根原在破岩中						
千磨万击还坚韧	任尔东南西北风						
青山处处埋忠骨	何须马革裹尸还						
落红不是无情物	化作春泥更护花						
他年我若为青帝	报与桃花一处开						
苟利国家生死以	岂因祸福避趋之						
采得百花成蜜后	为谁幸苦为谁甜						
忽如一夜春风来	千树万树梨花开						
夜阑卧听风吹雨。	铁马冰河入梦来。						
嫦娥应悔偷灵药	碧海青天夜夜心						
庄生晓梦迷蝴蝶	望帝春心托杜鹃						
苦恨年年压金线	为他人作嫁衣裳						
今年县宰加朱绂	便是生灵血染成						
十四万人齐解甲	宁无一个是男儿						
美人首饰侯王印	尽是沙中浪底来						
大风起兮云飞扬	威加海内兮归故乡						
路漫漫其修远兮	吾将上下而求索						
风萧萧兮易水寒	壮士一去兮不复还						
力拔山兮气盖世	时不利兮骓不逝						
蓦然回首那人却在	灯火阑珊处						
流水落花春去也	天上人间						
莫道不消魂帘卷西风	人比黄花瘦						
剪不断理还乱是离愁	别是一般滋味在心头						
问君能有几多愁	恰似一江春水向东流						
莫等闲白了少年头	空悲切						
昨夜西风凋碧树，独上高楼	望尽天涯路						
人有悲欢离合	月有阴晴圆缺						
但愿人长久	千里共婵娟						
山盟虽在	锦书难托						
寄意寒星荃不察	我以我血荐轩辕						
忍看朋辈成新鬼	怒向刀丛觅小诗						
躲进小楼成一统	管他冬夏与春秋						
心事浩茫连广宇	于无声处听惊雷						
无情未必真豪杰	怜子如何不丈夫						
铁肩担道义	妙手著文章						
砍头不要紧	只要主义真						
杀了夏明翰	还有后来人						
国破尚如此	我何惜此头						
踏遍青山人未老	风景这边独好						
千秋功罪	谁人曾与评说						
虎踞龙盘今胜昔	天翻地覆慨而慷						
我失骄杨君失柳	杨柳轻扬直上重霄九						
坐地日行八万里	巡天遥看一千河						
待到山花烂漫时	她在丛中笑						
一万年太久	只争朝夕						
可上九天揽月	可下五洋捉鳖						
西风烈	长空雁叫霜晨月						
一川烟草满城风絮	梅子黄时雨						
一日不见	如三月兮						
一夫当关	万夫莫开						
一水护田将绿绕	两山排闼送青来						
一叫一回肠一断	三春三月忆三巴						
一失足成千古恨	再回头已百年身						
一去紫台连朔漠	独留青冢向黄昏						
一年又过一年春	百岁曾无百岁人						
一自西施采莲后	越中生女尽如花						
一年好景君须记	正是橙黄橘绿时						
人生由命非由他	有酒不饮奈明何						
一身转战三千里	一剑曾当百万师						
十年心事十年灯	芭蕉叶上听秋声						
一枝秋艳露凝香	云雨巫山枉断肠						
一封朝奏九重天	夕贬潮阳路八千						
一看肠一断	好去莫回头						
一朝春尽红颜老	花落人亡两不知						
阿婆还似初笄女	头未梳成不许看						
一叶叶一声声	空阶滴到明						
一语天然万古新	豪华落尽见真淳						
一竿纶	世上如侬有几人						
古今多少事	都付笑谈中						
一箫一剑平生意	负尽狂名十五年						
一声何满子	双泪落君前						
一点浩然气	千里快哉风						
一双冷眼看世人	满腔热血酬知已						
一骑红尘纪子笑	无人知是荔枝来						
一丛深色花	十户中人赋						
一愿世清平	二愿身强健						
一愿郎君千岁	二愿妾身常健						
一杯愁绪	几年离索						
一顾倾人城	再顾倾人国						
二十四桥仍在	波心荡冷月无声						
青山隐隐水迢迢	秋尽江南草未凋						
二十四桥明月夜	玉人何处教吹萧						
七八个星天外	两三点雨山前						
人人尽说江南好	游人只合江南老						
人不寐	将军白发征夫泪						
二句三年得	一吟双泪流						
人生代代无穷已	江月年年只相似						
白云一片去悠悠	青枫浦上不胜愁						
谁家今夜扁舟子	何处相思明月楼						
江畔何人初见月	江月何年初照人						
人生天地间	忽如远行客						
人生不相见	动如参与商						
人生在世不称意	明朝散发弄扁舟						
人生如梦	一樽还酹江月						
人生到处知何似	恰似飞鸿踏雪泥						
泥上偶然留指爪	鸿飞那复计东西						
人生莫作妇人身	百年苦乐由他人						
人生得意须尽欢	莫使金樽空对月						
人世几回伤往事	山形依旧枕寒流						
人生无根蒂	飘如陌上尘						
人生富贵何所望	恨不嫁与东家王						
十年生死两茫茫	不思量自难忘						
十年如未死	卷土定重来						
十年别泪知多少	不道相逢泪更多						
十年寒窗无人问	一举成名天下知						
十年磨一剑	霜刃未曾试						
人从桥上过	桥流水不流						
人似秋鸿来有信	事如春梦了无痕						
人言落日是无涯	望极天涯不见家						
人事有代谢	往来成古今						
人到情多情转薄	而今真个不多情						
去年今日此门中	人面桃花相映红						
人皆养子望聪明	我被聪明误一生						
人皆讥造次	我独赏专精						
人间只道黄金贵	不问天公买少年						
人间亦有痴于我	岂独伤心是小青						
人闲桂花落	夜静春山空						
人逢喜事精神爽	月到中秋分外明						
人无千日好	花无百日红						
今夕复何夕	共此灯烛光						
明日隔山岳	世事两茫茫						
十觞亦不醉	感子故意长						
十指不沾泥	鳞鳞居大厦						
十年离乱后	长大一相别						
人生有命非由他	有酒不饮奈明何						
十五从军征	八十始得归						
三日入厨下	洗手作羹汤						
千山鸟飞绝	万径人踪灭						
山中一夜雨	树杪百重泉						
丈夫有泪不轻弹	只因未到伤心处						
山中何所有	岭上多白云						
丈夫非无泪	不洒离别间						
杖剑对尊酒	耻为游子颜						
山中无历日	寒尽不知年						
千古艰难惟一死	伤心岂独息夫人						
大江东去浪淘尽	千古风流人物						
山光悦鸟性	潭影空人心						
小舟从此逝	江海寄徐生						
才自清明志自高	生于未世运偏消						
久在樊笼里	复得近自然						
子系中山狼	得志便猖狂						
上言加餐食	下言长相忆						
久旱逢甘雨	他乡遇故知						
千村万落如寒食	不见人烟空见花						
山近月远觉月小	便道此山大于月						
辛苦遭逢起一经	干戈寥落四周星						
山河破碎风飘絮	身世浮沉雨打萍						
惶恐滩头说惶恐	零丁洋里叹零丁						
地若不爱酒	地应无酒泉						
三杯通大道	一斗合自然						
千呼万唤始出来	犹抱琵琶半遮面						
山抹微云	天连衰草						
千金纵买相如赋	脉脉此情谁诉						
芳草无情	更在斜阳外						
千秋万岁名	寂寞身后事						
山回路转不见君	雪上空留马行处						
小时不识月	呼作白玉盘						
小荷才露尖尖角	早有靖蜒立上头						
欲将轻骑逐	大雪满弓刀						
三朝三暮	黄牛如故						
夕阳方在半	忽坠乱流中						
夕阳牛背无人卧	带得寒鸦两两归						
夕阳西下	断肠人在天涯						
山围故国周遭在	潮打空城寂寞回						
山僧不解数甲子	一叶落知天下秋						
小楼一夜听春雨	深巷明朝卖杏花						
小楼昨夜又东风	故国不堪回首月明中						
山随平野尽	江入大荒流						
山静似太古	日长如小年						
千磨万击还坚劲	任尔东西南北风						
山鸡羞渌水	不敢照毛衣						
千秋青冢在	犹是汉宫春						
小儿误喜朱颜在	一笑那知是酒红						
小市三家聚	前村五里遥						
小园桃李东风后	却看杨花自在飞						
三月三日天气新	长安水边多丽人						
炙手可热势绝伦	慎莫近前丞相嗔						
上有青冥之长天	下有渌水之波澜						
丈夫志四海	万里犹比邻						
结庐在人境	而无车马喧						
问君何能尔	心远地自偏						
山气日夕佳	飞鸟相与还						
今人不见古时月	今月曾经照古人						
不才明主弃	多病故人疏						
天子呼来不上船	自称臣是洒中仙						
月上柳梢头	人约黄昏后						
何处望神州	满眼风光北固楼						
年少万兜鍪	坐断东南战未休						
少小离家老大回	乡音未改鬓毛衰						
月子弯弯照九州	几家欢乐几家愁						
心似双丝网	中有千千结						
日日花前常病酒	不辞镜里朱颜瘦						
奈心中事	眼中泪意中人						
今日送君须尽醉	明朝相忆路漫漫						
今日捉将官里去	这回断送老头皮						
天生我才必有用	千金散尽还复来						
天外黑风吹海立	浙东飞雨过江来						
少年十五二十时	步行夺得胡马骑						
心在天山	身老沧州						
爱上层楼	为赋新词强说愁						
夭地有正气	杂然赋流形						
少年安得长少年	海波尚变为桑田						
少年辛苦真食蓼	老景清闲如啖蔗						
今年花似去年好	去年人到今年老						
可惜明年花更好	知谁与同						
今年花落颜色改	明年花开复谁在						
半亩方塘一鉴开	天光云影共俳徊						
不如意事常八九	可与人言无二三						
少年听雨歌楼上	红烛昏罗帐						
而今听雨僧庐下	鬓已星星也						
悲欢离合总无情	一任阶前点滴到天明						
今年欢笑复明年	秋月春风等闲度						
五更鼓角声悲壮	三峡星河影动摇						
巴东三峡巫峡长	猿鸣三声泪沾裳						
月到天心处	风来水面时						
今夜月明人尽望	不知秋思在谁家						
不知何处吹芦管	一夜征人尽望乡						
今夜故人来不来	教人立尽梧桐影						
月明星稀	乌鹊南飞						
五花马	千金裘						
呼儿将出换美酒	与尔同销万古愁						
遥怜小儿女	未解忆长安						
不是一番寒澈骨	怎得梅花扑鼻香						
不要人夸好颜色	只留正气满乾坤						
不恨古人吾不见	恨古人不见吾狂耳						
将花揉碎掷郎前	请郎今夜伴花眠						
不是花中偏爱菊	此花开尽更无花						
不信芳春厌老人	老人几度送徐春						
不畏浮云遮望眼	自缘身在最高层						
不信楼头杨柳月	玉人歌舞未曾归						
中庭月色正清明	无数杨花过无影						
文章千古事	得失寸心知						
文章本天成	妙手偶得之						
天涯地角有穷时	只有相思无尽处						
日啖荔枝三百颗	不辞长作岭南人						
少贪梦里还家乐	早起前山路正长						
天阶月色凉如水	卧看牵牛织女星						
今朝有酒今朝醉	明日愁来明日愁						
少无适俗韵	性本爱丘山						
误人尘网中	一去三十年						
公道世间唯白发	贵人头上不曾饶						
天意怜幽草	人间重晚晴						
水满有时观下鹭	草深无处不呜蛙						
不管烟波下风雨	载将离恨过江南						
天苍苍野茫茫	风吹草低见牛羊						
不写情词不写诗	一方素帕寄心知						
日暮乡关何处是	烟波江上使人愁						
柴门闻犬吠	风雪夜归人						
日暮汉宫传蜡烛	轻烟散入五候家						
五岳寻仙不辞远	一生好入名山游						
我本楚狂人	凤歌笑孔丘						
不觉碧山暮	秋云暗几重						
不见采莲人	只闻花下语						
今夜偏知春气暖	虫声新透绿窗纱						
天街小雨润如酥	草色遥看近却无						
日出而作	日落而息						
世人皆欲杀	吾意独怜才						
世人都晓神仙好	唯有功名忘不了						
白也诗无敌	飘然思不群						
白日依山尽	黄河入海流						
白日放歌须纵酒	青春作伴好还乡						
才会相思	便害相思						
人面不知何处去	桃花依旧笑春风						
生年不满百	常怀千岁忧						
只在此山中	云深不知处						
未老莫还乡	还乡须断肠						
甘作一生拼	尽君今日欢						
世事一场大梦	人生几度秋凉						
世味年来薄似纱	谁令骑马客京华						
痴汉偏骑骏马走	巧妻常伴拙夫眠						
古来圣贤皆寂寞	唯有饮者留其名						
正是江南好风景	落花时节又逢君						
玉皇若问人间事	乱世文章不值钱						
四面荷花三面柳	一城山色半城湖						
本待将心托明月	谁知明月照沟渠						
出师未捷身先死	长使英雄泪满襟						
四时可爱唯春日	一事能狂便少年						
玉容寂寞泪阑干	梨花一枝春带雨						
打起黄莺儿	莫教枝上啼						
啼时惊妾梦	不得到辽西						
只恐双溪舴艋舟	载不动许多愁						
白骨露于野	千里无鸡鸣						
世间不少厅男子	谁肯沙场万里行						
奴为出来难	教郎恣意怜						
世间无限丹青手	一片伤心画不成						
可堪孤馆闭春寒	杜鹃声里斜阳暮						
玄都观里桃千树	尽是刘郎去后栽						
仗义半从屠狗辈	负心都是读书人						
世路如今已惯	此心到处悠然						
生当复来归	死当长相思						
田园廖落干戈后	骨肉流离道路中						
世态十年看烂熟	家山万里梦依稀						
功盖三分国	名成八阵图						
白发三千丈	缘愁似个长						
吊影分为千里雁	辞根散作九秋蓬						
且乐生前一杯酒	何须身后千载名						
可怜身上衣正单	心忧炭贱愿天寒						
白头宫女在	闲坐说玄宗						
可怜荒垅穷泉骨	曾有惊天动地文						
白发悲花落	青云羡鸟飞						
白发无情侵老境	青灯有味似儿时						
古调虽自爱	今人多不弹						
可怜一炬成焦土	留与东京说梦华						
未诸姑食性	先遣小姑尝						
可怜剃头者	人亦剃其头						
可怜无定河边骨	犹是春闺梦里人						
白头搔更短	浑欲不胜簪						
平芜尽处是春山	行人更在春山外						
白头纵作花园主	醉折花枝是别人						
只愿君心似我心	定不负相思意						
生时招不来	死时带不去						
古来虽有死	好在不先知						
田家供客无兼味	手摘黄柑换白鱼						
斗夜鸟啼霜正满	一帆斜月过枫桥						
市小人声寂	村寒鸡唱馀						
平生行乐惯	病起即看花						
四海交游今殆半	几人风雨对床眠						
生意忽满眼	不知春浅深						
只消几日憎腾醉	看年春风到牡丹						
世事云千变	浮生梦一场						
片片红梅落	纤纤绿草生						
正气堂堂贯斗牛	誓将贞节报君仇						
斗世无归似转蓬	今年作梦到巴东						
未悉前头花好否	且令蜂蝶作前驱						
北风三日无人渡	寂寞沙头一簇船						
石窦云封隐者家	一溪流水绕门斜						
白水满时双鹭下	绿槐高处一蝉吟						
未晚人家门户闭	鹭鸶闲立钩鱼船						
田父把犁寒雨足	牧儿吹笛晚风斜						
旦喜胸中无一事	一生常在平易中						
白头父子灯前语	忘却江湖久别离						
古寺深门一径斜	绕身萦面总烟霞						
古关衰柳聚寒鸦	驻马城头日欲斜						
军白鸟一双临水立	见人惊起人芦花						
古柳溪头枕断搓	横篙挂网几渔家						
古人谁不死	何必较考折						
四海无闲田	农夫犹饿死						
世情已逐浮云散	离恨空随江水长						
可怜日暮嫣香落	嫁与春风不用媒						
生女犹得嫁比邻	生男埋没随百草						
去年花里逢君别	今日花开又一年						
永夜角声悲自语	中天月色好谁看						
世间行乐亦如此	古来万事东流水						
四月南风大麦黄	枣花朱落桐叶长						
北寒妾已知	南心君不见						
生为百夫雄	死为壮士规						
四海皆兄弟	谁为行路人						
以胶投漆中	谁能别离此						
瓜田不纳履	李下不整冠						
出户独彷徨	愁思当告谁						
去者尸以疏	来者日已亲						
旦则既泛行	夜则悲吟坐						
各人自扫门前雪	休管他人瓦上霜						
舟人那识伤心地	遥指前程是马关						
行人欲问前朝事	翁仲无言对夕阳						
江水三千里	家书十五行						
杠上柳如烟	雁飞残月天						
江山如画	一时多少豪杰						
名山如高人	岂可久不见						
在山泉水清	出山泉水浊						
老天犹堪绝大漠	诸君何至位新亭						
如今七事都更变	柴米油盐酱醋茶						
仰天大笑出门去	我辈岂是蓬蒿人						
衣不如新	人不如故						
此中有真意	欲辩已忘言						
多少恨	昨夜梦魂中						
色不迷人人自迷	情人眼里出西施						
如今俱是异乡人	相见更无因						
此主此夜不长好	明月明年何处看						
自去自来堂上燕	相亲相近水中鸥						
我醉君复乐	陶然共忘机						
妆罢低声问夫婿	画眉深浅入时无						
弄潮儿向涛头立	手把红旗旗不湿						
芒鞋破钵无人识	踏过樱花第几桥						
车辚辚,马萧萧	行人弓箭各在腰						
我观人间世	无如醉人真						
何处夜归人	一犬吠深巷						
何处东风传笑语	隔花楼阁美人家						
身怯九天风露冷	楼台倒影浸秋星						
辛苦莫忘晨夜读	买书钱是绩麻钱						
坐觉尘嚣远	晴天卷片霞						
村原处处垂杨柳	一路青青到永城						
君家正在深树处	满地绿荫山鹧啼						
何事频频梦里归	只缘未惯客天涯						
我生功名付樽酒	衣如枯荷马如狗						
但愿郎防边	似妾缝衣密						
志士凄凉闲处老	名花零落雨中看						
把酒不能饮	苦泪滴酒觞						
把酒送春无别语	羡君才到便成归						
但求众生皆得饱	不辞赢卧病残阳						
言归汝亦无归处	何用多言伤我情						
吹落杨花春事了	小池新绿雨添痕						
我亦旦如常日醉	莫教弦管作离声						
何事吟馀忽惆怅	村桥原树似吾乡						
我醉欲眠卿且去	明朝有意抱琴来						
吾观自古贤达人	功成不退皆殒身						
别有幽愁暗恨生	此时无声胜有声						
志士幽人莫怨嗟	古来材大难为用						
邪径败良田	谗口乱善人						
良时不再至	离别在须臾						
我欲与君相知	长命无绝衰						
男儿爱后妇	女子重前夫						
昔人已乘黄鹤去	此地空余黄鹤楼						
佳人犹唱醉翁词	四十三年如电抹						
其人虽已没	千载有馀情						
取之不尽	用之不竭						
空山松子落	幽人应未眠						
松下问童子	言师采药去						
枕上诗篇闲处好	门前风景雨来佳						
青山缭绕疑无路	忽见千帆隐映来						
两三点露不成雨	七八个星犹在天						
夜月一帘幽梦	春风十里柔情						
雨中山果落	灯下草虫鸣						
明日巴陵道	秋山又几重						
明月出天山	苍茫云海间						
松月生夜凉	风泉满清听						
青天有月来几时	我今停杯一问之						
明月如霜	好风如水						
明月几时有	把酒问青天						
明月皎皎照我床	星汉西流夜示央						
雨中黄叶树	灯下白头人						
明月照积雪	北风劲且哀						
昔日戏言身后事	今朝都到眼前来						
征夫怀远路	游子恋故乡						
采石江边一杯土	李白之名高千古						
佳名奚囊盛不住	满山风雨送人看						
夜半桥边呼孺子	人间犹有未烧书						
长安一片月	万户捣衣声						
取次花丛懒回顾	半缘修道半缘君						
长江后浪推前浪	一代新人换旧人						
来如春梦几多时	去似朝云无觅处						
昔去雪如花	今来花如雪						
孤帆远影碧空尽	唯见长江天际流						
花自飘零水自流，一种相思	两处闲愁						
知否？知否？	应是绿肥红瘦						
孤村到晓犹灯火	知有人家夜读书						
知我者	二三子						
忽见陌头杨柳色	悔教夫婿觅封侯						
林花谢了春红	太匆匆						
青青子衿	悠悠我心						
花明月黯飞轻雾	今宵好向郎边去						
往事只堪哀	对景难排						
昔别君未婚	儿女忽成行						
花非花	雾非雾						
青青河畔草	郁郁园中柳						
夜来风雨声	花落知多少						
其奈风流端整外	更别有系人心处						
畏于春梦几多时	散似秋云无觅处						
花近高楼伤客心	万方多难此登临						
两岸猿声啼不住	轻舟已过万重山						
始知锁向金笼听	不及林间自在啼						
畏恨人心不如水	等闲平地起波澜						
物是人非事事休	欲语泪先流						
往事已成空	还如一梦中						
束风不与周郎便	铜雀春深锁二乔						
长亭外古道边	芳草碧连天						
畏恨此身非我有	何时忘却营营						
门前冷落车马稀	老大嫁作商人妇						
松风吹解带	山月照弹琴						
东风吹醒英雄梦	不是咸阳是洛阳						
长相思	在长安						
枕前泪共阶前雨	隔个窗儿滴到明						
长城万里今犹在	不见当年秦始皇						
昔时人已没	今日水犹寒						
花径不曾缘客扫	蓬门今始为君开						
昔时横波目	今作流泪泉						
居高声自远	非是藉秋风						
羌笛何须怨杨柳	春风不渡玉门关						
夜深更饮秋潭水	带月连星舀一瓢						
东飞伯劳西飞燕	黄姑织女时相见						
松间明月长如此	君再游兮复何时						
两情若是长久时	又岂在朝朝暮暮						
夜深忽梦少年事	梦啼妆泪红阑干						
夜深风竹敲秋韵	万叶千声皆是恨						
夜宿峰顶寺	举手扪星长						
夜凉吹笛千山月	路暗迷人百种花						
雨笠烟蓑归去也	与人无爱亦无嗔						
两脚踏翻尘世路	一肩担尽古人愁						
兄童共道先生醉	折得黄花插满头						
儿童相见不相识	笑问客从何处来						
直须看尽洛城花	始共东风容易别						
花须连夜发	莫待晓风吹						
忽喇喇似大厦倾	昏惨惨似灯将尽						
牧童归去横牛背	短笛无腔信口吹						
忽有一觞酒	日夕欢相持						
命里有时终须有	命里无时莫强求						
忽闻河东狮子吼	拄杖落手心茫然						
直道相思了无益	未妨惆怅是清狂						
忽闻海上有仙山	山在虚无缥缈间						
忽闻歌古调	归思欲沾巾						
空山不见人	但闻人语响						
青箬笠绿蓑衣	斜风细雨不须归						
两个黄鹂鸣翠柳	一行白鹭上青天						
门掩黄昏	无计留春住						
夜台无李白	沽酒与何人						
所谓伊人	在水一方						
芳树无人花自落	春山一路鸟空啼						
东边日出西边雨	道是无情却有情						
夜阑更秉烛	相对如梦寐						
拂墙花影动	疑是玉人来						
妾本舟中客	闻君江上琴						
妨苏城外寒山寺	夜半钟声到客船						
波澜誓不休	妾心古井水						
长向江湖押欧鸟	梦魂夜夜觚棱绕						
夜月柳阴人未寝	村翁荒渺说隋唐						
孤村日暮渔舟小	好逐烟波带月回						
芹泥满地日初暖	燕子一双花外来						
青草原头送客归	绿杨溪上对斜晖						
忽见疏育落香雪	水边竹里半横枝						
雨足桔槔声暂歇	翠畦瓜豆已成行						
畏桥带修行	野水抱人家						
儿童不知春	问草何故绿						
枕上听猿啼	家乡五千里						
青山尽日尽帘坐	落尽棕相一树花						
明星在高树	满田萤火飞						
牧雏不管蓑衣湿	一笛春风倒跨牛						
柬风吹雨衣不湿	我在桃花深处行						
到处青山山有树	如何偏起故乡情						
儿童刻竹记新笋	一夜风吹一尺强						
两岸好山送客	一江细雨归人						
林深不见人家住	道上唯闻打麦声						
儿童娱膝下	母子话灯前						
明朝大江送吾去	万里无风吹客衣						
兄女不知来避地	强言风物胜江南						
枕稳衾温梦不回	闲居不怕漏声催						
花鸟总知春烂缦	人间独自有伤心						
夜来似与君相见	明月一窗梅影横						
雨歇林间凉自生	风穿径里晓逾清						
儿童未解供耕织	也傍桑阴学种瓜						
夜窗父子共煎茶	一点青灯冷结花						
阴外不知春雪荠	半峰残月一溪水						
林花过雨相急发	谷鸟无人自在啼						
儿童牧鹅鸭	妇女治桑麻						
夜闻归雁生乡思	病人新年感物华						
空作对雪吟	勤勤谢知己						
床头一壶酒	能更几回眠						
昔日芙蓉花	今成断肠草						
近乡情更怯	不敢问来人						
未是空言去绝踪	月斜楼上五更钟						
空山新雨后	天气晚来秋						
明朝有封事	数问夜如何						
呼儿将出换美酒	与尔同消万古愁						
背为鸳与鸯	今为参与辰						
使君自有妇	罗敷自有夫						
花花自相对	叶叶自相当						
居常土思兮心内伤	愿为黄鹄兮归故乡						
来世不可待	往世不可追						
风一更	雪一更						
聒碎乡心梦不成	故园无此声						
故人入我梦	明我长相忆						
美人自古如名将	不许人间见白头						
故人具鸡黍	邀我至田家						
美人含怒夺灯去	问郎知是几更天						
春水碧于天	画船听雨眠						
客心洗流水	余响入霜钟						
待月西厢下	迎风户斗开						
郎今欲渡缘何事	如此风波不可行						
近水楼台先得月	向阳花木易为春						
念去去千里烟波	暮霭沉沉楚天阔						
风乍起	吹皱一池春水						
胡未灭	鬓先秋						
若有人知春去处	唤取归来同住						
二分尘土	一分流水						
竹外桃花三两枝	春江水暖鸭先知						
蒌蒿满地芦芽短	正是河豚欲上时						
风光如此须行乐	莫管头颅白几茎						
春有百花秋有月	夏有凉风冬有雪						
若无闲事挂心头	便是人间好时节						
春色恼人眠不得	月移花影上栏杆						
侯门一入深如海	从此萧郎是路人						
为求一字稳	耐得半宵寒						
红豆生南国	春来发几枝						
愿君多采撷	此物最相思						
持谢邻家子	效颦安可希						
思君如满月	夜夜减清辉						
相见争如不见	有情还似无情						
相见或因中夜梦	寄来多是隔年书						
春花秋月何时了	往事知多少						
为君持酒劝斜阳	且向花间留晚照						
狗吠深巷中	鸡鸣桑树颠						
若言琴上有琴声	放在匣中何不呜						
若言声在指头上	何不于君指上听						
看似寻常最崎岖	成如容易却艰辛						
易求无价宝	难得有情郎						
独上高楼	望尽天涯路						
若到江南赶上春	千万和春住						
夙雨如晦	鸡鸣不已						
青山依旧在	几度夕阳红						
争知我倚阑干处	正恁凝愁						
昨夜松边醉倒	问松我醉何如						
只疑松动要来扶	以手推松曰去						
昨夜星辰昨夜风	画楼西畔桂堂东						
待到重阳日	还来就菊花						
春衫著破谁针线	点点行行泪痕满						
春雨楼头尺八萧	何时归看浙江潮						
春风十里扬州路	卷上珠帘总不如						
秋风入庭树	孤客最先闻						
若待上林花似锦	出门俱是看花人						
相恨不如潮有信	相思始觉海非深						
春风不相识	何事入罗帷						
黄河远上白云间	一片孤城万仞山						
羌笛何须怨杨柳	春风不度玉门关						
凤急天高猿啸哀	渚清沙白鸟飞回						
艰难苦恨繁霜鬓	潦倒新停浊酒杯						
珍重主人心	酒深情亦深						
相思本是无凭语	莫向花笺费泪行						
春秋多佳日	登高赋新诗						
秋风吹不尽	总是玉关情						
秋风吹渭水	落叶满长安						
周郎妙计安天下	赔了夫人又折兵						
相看两不厌	只有敬亭山						
却看妻子愁何在	漫卷诗书喜欲狂						
春风知别苦	不遣柳条青						
相思相见知何日	此时此夜难为情						
迢迢牵牛星	皎皎河汉女						
相思欲寄无从寄	画个圈儿替						
春风阆苑三千客	明月扬州第一楼	赵孟颁					
相思衬底说相思	思郎恨郎郎不知	梁启超					
相思难表	梦魂无据		惟有归来是 欧阳修				
春宵一刻值千金	花有清香月有阴	苏轼					
春眠不觉晓	处处闻啼鸟	孟浩然					
为问生身亲阿母	卖儿还剩几多钱？佚名						
苦恨年年压金线	为他人作嫁衣裳	秦韬玉					
枯桑知天风	海水知天寒	佚名					
胡马依北风	越鸟巢南枝	佚名					
后宫佳丽三千人	三千宠爱在一身	白居易					
是气所碲礴	凛烈万古存	文天祥					
美酒饮教微醉后	好花看到半开时	邵雍					
却笑溪声忙底事	奔流偏欲到人间	赵愈					
风流儒雅亦吾师 杜甫							
若得山花插满头	莫问奴归处	严蕊					
柔情似水	佳期如梦	秦观					
柳条折尽花飞尽	借问行人归不归？佚名						
相望知不见	终是屡回头听 皇甫曾						
为国为民皆是汝	却教桃李职笙歌	解缙					
便做春江都是泪	流不尽		许多愁！秦观				
故国神游	多情应笑我		早生华发。苏轼				
相逢却道空辛苦	抽得丝来还别人	翁卷					
相逢莫问人间事	故国伤心祗泪流	苏曼殊					
思悠悠	恨悠悠		恨到归时方始休。白居易				
风情犹拍古人肩 黄庭坚							
枯鱼过河泣	何时悔复及？古诗源						
故国梦重归	觉来双泪垂	李煜					
春欲暮	思无穷		旧观如梦中！温庭筠				
客从远方来	遗我双鲤鱼	佚名					
红酥手	黄藤酒		清城春色宫墙柳。陆游				
故乡今夜思千里	霜鬓明朝又一年	高适					
南朝四百八十寺	多少楼台烟雨中	杜牧					
品画先神韵	论诗重性情	袁枚					
洛阳城东桃李花	飞来飞去落谁家？刘希夷						
洛阳城里春光好	洛阳才子他乡老	韦庄					
春韭满园随意剪	腊醅半瓮邀人酌	郑燮					
洛阳亲友如相问	一片冰心在玉壶	王昌龄					
於无声处听惊雷 鲁迅							
郡道天凉好个秋 辛弃疾							
为爱好多心转惑	遍将宜称问旁人	韩屋					
城里看家多白发	游春总是少年人	麻九畴					
却嫌脂粉颜色 张祜							
垂杨密密指行装	芳草萋萋碍行路	黄景仁					
冠盖满京华	斯人独憔悴	杜甫					
春愁难遣强看山	往事心惊泪欲潜；四百万人同一器		去年今日割台湾。丘逢甲				
春种一粒粟	秋收万颗子；四海无闲田		农夫犹饿死！李绅				
看尽人间兴废事	不曾富贵不曾穷	陆游					
秋尽江南草木雕 杜牧							
屋漏更遭连夜雨	船迟又遇打头风	醒世恒言					
风鸣两岸叶	月照一孤舟	孟浩然					
河汉清且浅	相去复几许；盈盈一水间		脉脉不得语。佚名				
昏惨惨	黄泉路近	曹雪芹					
建德非吾土	维扬忆旧游	孟浩然					
香稻啄徐鹦鹉粒	碧梧栖老凤凰枝	杜甫					
篇赋新词强说愁 辛弃疾							
怒发冲冠凭栏处	潇潇雨歇		抬望眼	仰天长啸	壮怀激烈。岳飞		
风头如刀面如割 岑参							
科头箕踞长松下	白眼看他世上人	王维					
便纵有千种风情	更与何人说？柳永						
红烛自怜无好计	夜寒空替人垂泪	晏几道					
风声	雨声		读书声	声声入耳；家事	国事	天下事	事事关心。顾宪成
红颜未老恩先断 白居易							
枯藤老树昏鸦	小桥流水人家		古道西风瘦马。马致远				
春归何处？寂寞无行路。黄庭坚							
风檐展书读	古道照颜色	文天祥					
红颜自古多薄命 欧阳修							
郎骑竹马来	绕床弄青梅；同居长千里		两小无嫌猜。李白				
幽怀谁共语	远目送归鸿	元遗山					
便觉眼前生意满	东风吹水绿参差	张拭					
夙飘飘	雨潇潇		便做陈抟也睡不着。关汉卿				
相顾无言	唯有泪千行	苏轼					
春蚕到死丝方尽	虹炬成灰泪始干	李商隐					
茅店鸡声霜月白	故乡儿女正安眠	商奂					
凤残杏花晓	马上闻啼鸟	高启					
幽禽雨中响	门掩春塘绿	高启					
飞将远从戎	翩翩气自雄	徐渭					
英雄心事无今古	神物风云各有时		张佳胤				
思妇楼头月	征人马上霜	章美中					
客来客去日日	花开花落年年	徐贲					
孤云在于际	回首若有情	于谦					
南窗一枕睡初觉	蝴蝶满园如雪飞	华幼武					
春来十日无人见	一树寒梅已著花	王					
表里山河犹往日	变迁朝市已多年	马中锡					
春风如少年	狂逐无定处	陈孚					
前溪渔掉归无数	网挂船头晒夕阳	翁葵					
篇爱梅花月	终宵不肯眠	戴敏					
怕恐摊头说惶恐	零丁洋里汉零丁	文天祥					
春雨断桥人不渡	小舟哲学家出柳阴来	徐俯					
幽人枕上朦胧睡	卧看东风次第明	张耒					
是非不到野溪边	只就梧桐听雨眠	方岳					
春溪嫩水清无渣	春洲细草碧无暇	杨万里					
扁舟烟重冷渔蓑	两岸人家浸小河	斯植					
风来一阵芦花过	祗道春残柳絮飞	叶茵					
星光欲没晓光连	霞晕红浮一角天	黄大受					
幽人耐冷倚门久	送月堕湖归去来	陆游					
孤灯挑到寒更尽	犹有行人带雨归	胡仲参					
客里不知春去尽	满山风雨落桐花	林表明					
孤舟横笛向何处？林外炊烟一两家。蔡襄							
故人情可见	何用送行诗	徐积					
夙急花初尽	春深鸳乱啼	邹登龙					
陌上花开蝴蝶飞	江山犹是昔人非	苏轼					
秋景有时飞独鸟	夕阳无事起寒烟	林逋					
故园东望路漫漫	双袖龙钟泪不乾	岑参					
便使兰膏夜	炯炯对繁霜	刘孝绰					
春风不为吹愁去	春日偏能惹恨长	贾至					
相看白刃血纷纷	死节从来岂顾勋	高适					
春水船如天上坐	老年花似雾中看	杜甫					
孤舟蓑笠翁	独钓寒江雪	柳宗元					
春风桃李花开日	秋雨梧桐叶落时	白居易					
春潮带雨晚来急	野渡无人舟自横	韦应物					
春来遍是桃花水	不辨仙源何处寻	王维					
洛阳女儿对门居	才可容颜十五余	王维					
是耶非孜孜不倦	立而望之	汉武帝					
春兰兮秋菊	长无绝佤绝古	居原					
风萧萧兮易水寒	壮士一去兮不复还！史记						
 							
十画							
时人不识余习乐	将谓偷闲学少年	程颢					
射人先射马	擒贼先擒王	杜甫					
海人无家海里住 王建							
海入愁肠	化作相思泪	范仲庵					
海上生明月	天涯共此时	张九龄					
宫女如花满雄殿	只今惟有鹧鸪飞	李白					
马上相逢无纸笔	凭君传语报平安	岑参					
哑子漫尝黄柏味	难将苦口向人言	京本通俗小说					
海日生残夜	江春入旧年	王湾					
书中自有黄金屋	书中自有颜如玉	宋真宗					
海内存知己	天涯若比邻	王勃					
挽水西流想无未能	从今不养五更鸡	黄遵宪					
座中润下谁最多？江州司马青衫湿。白居易							
流水落花春去也	天上人间	李煜					
流水无情草自春 杜牧							
病中最觉风露早	归梦不知山水长	王安石					
草木摇落露为霜 曹丕							
悄立市桥人不识	一星如月看多时	黄景仁					
浮生长恨欢娱少	肯爱千金轻一笑	宋祁					
书生事业真堪笑	忍冻孤吟笔退尖	苏轼					
浮生恰似冰底水	日夜东流人不知	杜牧					
舍册埋头无了日	不如抛却去寻春	朱熹					
峙危见臣节	世乱识忠良	鲍照					
流光容易把人抛	红了樱桃		绿了芭蕉。蒋捷				
道次第	怎一个愁字了得！李清照						
修竹万竿松影乱	山凤吹作满窗云	萨都刺					
家在万重云外	心事付横笛	陆游					
草色遥看近却无 韩愈							
马因识路真疲路	蝉到吞声尚有声	黄景仁					
桃花一簇开无主	可爱深红间浅红	杜甫					
骨朽人间骂未销 刘子晕							
情何人唤取	红中翠袖		温英雄泪。辛弃疾				
栽花忙处儿呼饭	夜读深时妾屏灯	袁枚					
荒村雨露宜眠早	野店风霜要起迟	王实甫					
桃李春风一杯酒	江湖夜雨十年灯	黄庭坚					
倚杖柴门外	临风听暮蝉	王维					
家住苍烟落照问	丝毫尘事不相关	陆游					
穿花蛱蝶深深见	点水晴蜓款款飞	杜甫					
桃花吹尽	佳人何在？门掩残红	张可久					
桃花潭水深千尺	不及汪伦送我情	李白					
酒到醒时愁复来	书堪咀处味逾久	陶十璜					
除却天边月	没人知！韦庄						
海风吹不断	工月照还空	李白					
茫茫宇宙人无数	几个男儿是丈夫？吕洞宾						
宰相有权能割地	孤臣无力可国天	丘逢甲					
疾风知劲草	板荡识诚臣	李世民					
酒是治愁药	书是引睡媒	陆游					
悠哉修哉	辗转反侧	诗经					
荒城临古流	落日满秋山	王维					
草枯鹰眼疾	雪尽马蹄轻	王维					
躬耕本是英雄事	老死南阳未必非	陆游					
借问因何太瘦主？只为从来作诗苦。李白							
家家扶得醉人归。王驾							
秦时明月汉时关	万里长征人未还	王昌龄					
借问春归何处所。欧阳修							
借间酒家何处有	牧童遥指杏花村	杜牧					
庭院深深深几许。欧阳修							
粉骨碎身浑不怕	要留清白在人间！于谦						
个个诗家各筑坛	一家横割一江山	杨万里					
留得累人身外物	半肩行李半肩书	张问陶					
纪得那年花下	深夜		初识谢娘时。韦度				
留得枯荷听雨声。李商隐							
窈窕淑女	君子好逑	诗经					
记得绿罗裙	处处怜芳草	牛希济					
家国兴亡自有时	吴人何苦怨西施	罗隐					
留得戏蝶时时舞	自在娇莺恰恰啼	杜甫					
浩然一曲酒千钟	男儿行处是		未要论穷通。元遗山				
书画琴棋诗酒花	当年件件不离他	查为仁					
哦诗不睡月满船	清寒入骨我欲仙	陆游					
书当快意读易尽	客有可人期不来	陈师道					
氮蒸云梦泽	波撼岳阳城	孟浩然					
浮云游子意	落日敌人情	李白					
浮云蔽白日	游子不顾返	佚名					
蚍蜉撼大树	可笑不自量	韩愈					
层滑霜浓	不如休会		真是少人行。周邦彦				
笑渐不闻声渐悄	多情却被无情恼	苏轼					
剔尽寒灯梦不成 朱淑贞							
倚剑长歌一杯酒	浮云西北是神州	元遗山					
庭树不知人去尽	春来还发旧时花	岑参					
送君送苏州	泪落送行处	江堤					
纪取灵川好风味	新茶新豆到山城	查慎行					
马后桃花马前雪	出关争得不回头	徐兰					
酒酣忘却身为客	意欲元同送者归	张元凯					
书卷多情似故人	晨昏忧乐每相亲	于谦					
桃花一树鱼三尺	不醉月明船不归	陈继儒					
高高下下梅千树	家在花中香不知	陈继儒					
茶坞落英堆满寸	怪来茶味是梅花	陈继儒					
马上相逢须尽醉	是朝知隔几重山	谢肇制					
酒尽客亦醉	满江空月明	贡师泰					
草肥凉露白	树薄晓风清	袁桷					
送别莫忘今日	相逢知在何年	萨都刺					
桃花嫣然出篱笑	似开未开最有情	汪藻					
茫然不悟身何处	水色天光共蔚蓝	韩驹					
病眼看人殊草草	隔林迢递见梅花	刘克庄					
荒寒茅屋是谁家？独木桥横小径斜。杨公远							
乘兴宋来就榻眠	一枕春风君莫惜	方惟深					
柴门草径尽梅苔	不放红尘俗子来	杨万里					
酒醒门外三竿日	卧看溪南十亩阴	苏轼					
浮生六十度春秋	无辱无荣尽自由	杨公远					
桑竹成荫不见门	半羊分路各归村	陆游					
送客客已去	寻花花未开	苏轼					
高风自绝人	正行不违俗	韩屋					
荒田寂寞无人声	水边跳鱼翻水晌	张耒					
草草杯盘供笑语	昏昏灯火话平生	王安石					
草木本有心	何求美人折？张九龄						
桃花流水冒然去	别有天地非人间	李白					
海内风尘诸弟隔	天涯涕泪一身遥	杜甫					
借问路旁名利客	何如此处学长生	崔颢					
浮沉千古事	谁与问东流	薛莹					
浮云一别后	流水十年问	韦应物					
捐躯赴国难	视死忽如归	曹植					
烈士多悲心	小人偷自闲	曹植					
烈士暮年	壮心未已	曹操					
十一画							
头号人生到此凄凉否？千万恨	为兄剖	顾页观					
逢人怕问前程驿	一水东航是马关	郁达夫					
商人重利轻别离	前月浮梁买茶去	白居易					
无人信高洁	谁为表予心？骆宾王						
无力买田聊种水	近来湖面亦收租	范成大					
矣乃一声山水绿 柳宗元							
商女不知亡国恨	隔江犹唱后庭花！杜牧						
欲上青天览明月 李白							
卷土重来未可知	江山亦要伟人持	丘逢甲					
国仇未报壮士老	匣中宝剑夜有声	陆游					
都云作者痴	谁解其中味？曹雪芹						
强中更遇强中手	恶人须服恶人磨	醒世恒言					
烽火连三月	家书抵万金	杜甫					
带月荷锄归 陶渊明							
野水无人渡	孤舟尽日横	寇准					
望夫处	江悠悠；化为石		不回头	山头日日风复雨	行人归来石应语。王建		
挽弓当挽强	用箭当用长	杜甫					
野火烧不尽	春风吹又生	白居易					
造化钟神秀	阴阳割昏晓	杜甫					
牵牛织女遥望	尔独何辜限河梁？曹丕						
剪不断	理还乱		是离愁	别是一番滋味在心头！李煜			
处世若大梦	胡为劳其主？李白						
无可奈何花落去	似曾相识燕归来		小园香径独徘徊。晏殊				
鸟去鸟来山色里	人歌人哭水声中	杜牧					
问世间情是何物？直教生死相许。元遗山							
庄生晓梦迷蝴蝶	望帝春心托杜鹃	李商隐					
盛年不重来	一日难再晨	陶渊明					
无肉令人瘦	无竹令人俗	苏东坡					
得成比目何辞死	愿作鸳鸯不羡仙	卢照邻					
郴江幸自绕郴山	为谁流下潇湘去	泰观					
野老念牧童	倚杖侯荆扉	王维					
惟有南风旧相识	偷开门户又翻书	刘分					
徙此无心爱良夜	任他明月下西楼	李益					
终年无客常闭关	终日无心长自闲	王维					
莫向樽前借沉醉	与君俱是异乡人	韦庄					
莫言下岭便无难	赚得行人错喜欢	杨万里					
欲把西湖比西子	淡妆浓抹总相宜	苏轼					
欲忘忘未得	欲去去无由	白居易					
问余何意栖碧山？笑而不答心自闲；桃花流水官然去	别有天地非人间	李白					
停车坐爱枫林晚	霜叶红于二月花	杜牧					
细推物理须行乐	何用浮名绊此身？杜甫						
问君能有几多愁？恰似一江春水向东流。李煜							
欲作家书意万重 张籍							
梨花院落溶溶月	柳絮池塘淡淡风	晏殊					
欲别牵郎衣	郎今到何处		不恨归来迟	莫向临邛去。孟效			
猛志逸四海	骞翮思还翥	陶潜					
无言独上西楼	月如钩	李煜					
眼波才动被人猜 李清照							
莫怪世人容易老	青山也有白头时	骆绮兰					
都来此事	眉间心上		无计相回避。范仲庵				
深知身在情长在 李商隐							
纫雨鱼儿出	微风燕子斜	杜甫					
黄昏风雨打园林	残菊飘零满地金	王安石					
莫怪春来便归去	江甫虽好是他乡	王恭					
清明时节雨纷纷	路上行人欲断魂	杜牧					
黄河远上白云间	一片孤城万初山	王之涣					
翎雨梦回鸡塞远	小楼吹彻玉笙寒	李颢					
欲取鸣琴弹	恨无知间赏	孟浩然					
捉来系日乏长绳 李商隐							
问姓惊初见	称名忆旧容	李益					
惟草木之零落兮	恐美人之迟暮	屈原					
眼看他起朱楼	眼看他宴宾客		眼看他楼塌了。孔尚任				
欲待曲终寻问取	人不见		数峰青。苏轼				
将军百战死	壮士十年归	佚名					
莫思身外无穷事	且尽生前有限杯	杜甫					
细看来不是	杨花点点		是离人泪。苏轼				
清风明月无人管	并作甫来一味凉	王安石					
谅风起天未	君子意如何？杜甫						
荷风送香气	竹露滴清晌	孟浩然					
淮南皓月冷千山。冥冥归去无人管。姜夔							
莫信诗人竞平淡	二分梁甫一分骚	龚自珍					
钢柳新蒲为谁绿 杜甫							
贫家一碗灯	父子相聚哭	陈烈					
清时有味是无能	闲爱孤云静爱僧	杜牧					
深恩负尽	死生师友	顾贞观					
鱼书欲寄何由达？水远山长处处同。晏殊							
怅望千秋一洒泪	萧条异代不同时	杜甫					
无情不似多情苦	一寸还成千万缕	晏殊					
欲将心事付瑶琴	知音少		弦断有谁听？岳飞				
采得百花成蜜后	为谁辛苦为谁甜	罗隐					
无情有恨何人见 李贺							
岛宿池边树	僧敲月下门	贾岛					
欲寄君衣君不还	不寄君衣君又寒；寄与不寄间		妾身千万难！姚发				
黄菊枝头主晓寒	人生莫放酒杯干	黄庭坚					
采菊东篱下	悠然见南山	陶渊明					
莫将后日情	不如初见时	王渥					
欲寄相思千点泪	流不到		楚江东。苏轼				
泪眼问花花不语	乱红飞过秋千去	欧阳修					
黄梅时节家家雨	青青池塘处处蛙	赵师秀					
惟将终夜长开眼	报答平生未展眉	无稹					
荷立带斜阳	青山独归远	刘长卿					
欲寄彩笺兼尺素	山长水阔知何处	晏殊					
无情最是台城柳	依旧烟笼十里堤	韦庄					
羞将短发还吹帽子	笑情旁人为正冠	杜甫					
敏捷诗千首	飘零酒一杯	杜甫					
欲祭疑君在	天涯哭此时	张籍					
侧恻轻寒剪剪风 韩屋							
寂寂寥寥扬子居	年年岁岁一床书	卢照邻					
清晨一失后难摹 苏轼							
关万古得未曾有之奇	洪荒留此山川		作遗民世界。沈葆桢				
斜阳外	寒邪数点		流水绕孤村。秦观				
问渠那得清如许	为有源头活水来	朱熹					
异乡物态与人殊	惟有东风旧相识	欧阳修					
欲买桂花同载酒	终不似		少年游。刘过				
莫等闲	白了少年白		空悲切。岳飞				
欲渡黄河冰塞川	将登太行雪满山	李白					
野渡无人舟自横 韦应物							
梅须逊雪三分白	霜却输梅一段香	卢梅坡					
梨园子弟白发新 白居易							
清诗句句尽堪传 杜甫							
袈裟未著悉多事	著了袈裟事更多	杨万里					
无意苦争春	一任群芳妒	陆游					
哉想英雄垂暮日	温柔不住住何乡？龚自珍						
莫愁前路无知己天下谁人不识君！高适							
寂寞无人见 苏轼							
无意怀人偏入梦	有心看月未当圆	方贞观					
陶尽门前土	屋上无片瓦；十指不沾泥		鳞鳞居大厦。梅尧臣				
章台柳	章台柳		昔日青青今在否？韩翊				
无欲自然心如水	有营何止事如毛	赵师秀					
细数落花因坐久	缓寻芳草得归迟	王安石					
无缘何生斯世	有情能累此生		傅斯年				
访旧半为鬼	惊呼热中肠	杜甫					
野旷天低树	江清月近人	孟浩然					
野旷天清无战声	四万义军同日死	杜甫					
无边落木萧萧下	不尽长江滚滚来	杜甫					
莫辞更坐弹一曲	为君翻作琵琶行	白居易					
得饶人处且饶人。醒世恒言							
黄鹤一去不复返	白云千载空悠悠	崔颢					
欲识官司心肠	但看民饥肤	陆继略					
欲采盈盈太孤绝	胸中长此玉峥嵘	严复					
停车间村酒	倚树听疏蝉	李日华					
梨花风雨后	人在绿杨中	冯氏					
探梅诗客多清趣	瘦赛冲寒溪上去	子谦					
斜阳几处吹芦笛	头戴衣裳渡水归	姜玄					
晨光海上来	云山生万壑	黄清老					
野老相过无一事	白头喜对酒盈缸	邦韶					
悠悠窗下断肠波	总是行人堕泪多		刘昂				
凄凉今夜月	照我故乡情		于石				
从今别却江甫路	化作啼鹃带血归	文天祥					
遵宵作而知丰年	老妻饱饭儿童喜	王庭诖					
悠悠绿水分支港。撑出南邻放鸭船。叶绍翁							
野鸭被人惊得惯	作群飞去却飞回		杨万里				
虎处绿波通酒巷	女郎多在采菱舟	张良臣					
篇飞欲尽暮烟横	一笛西几万里晴	朱继芳					
卿跟倦时且小歇	山色佳处须细看	杨万里					
雪含欲下不下意	梅带将开未开色		曾几				
野鹤忽来桥上立	山僧独自水边行	张戈					
淡色似黄杨叶小	浓香如蜜菜花多	徐玑					
雪后春生人未觉悟	弄丝鳍子独先知	杨万里					
荷边弄水一身香	竹里招几满扇凉	杨万里					
悠哉四子心	共此千里明	苏轼					
造物亦知人亦老	故使江西向西流	苏轼					
斜阳照墟落	穷巷牛羊归	王维					
莫以今时宠	难忘旧日恩	王维					
莫是长安行乐处	空令岁月易蹉跎	李颀					
梧桐相待老	鸳鸯会双死	孟郊					
将家就鱼麦	紧老江湖边	元结					
寂寞空庭春欲晚	梨花满地不开门	刘方平					
欲穷千里目	更上一层楼	王之涣					
惆怅南朝事	长江独至今	刘长卿					
寂寂何所待	朝朝空自归	孟浩然					
偶然值林皇	谈笑无还期	王维					
尽短苦夜长	何不秉烛游	无名氏					
参辰皆已没	去去从此辞	苏武					
悠悠苍天	曷其有极	诗经					
十二画							
云一剐	玉一梭		澹澹衫儿薄薄罗。李煜				
叶上初阳乾宿雨	水面清圆		——风荷举。周邦彦				
云心自向山山去	何处灵山不是归？熊孺登						
乡心新岁切	天畔独潸然	刘长卿					
残月晓风仙掌路	何人为吊柳屯田？王士祯						
朝如表丝暮成雪。李白							
曾因酒醉鞭名马	生怕情多累美人	郁达夫					
晚年惟好静	万事不关心	王维					
畿次细思量	情愿相思苦	胡适					
换我心	为你心		始知相忆深。雇琼				
榔村四月闲人少	才了蚕丝又插田	翁卷					
闲花只好闲中看	一折归来便不鲜	刘廷玑					
弃我去者	昨日之日不可留；乱我心者		今日之日多烦忧。李白				
闲坐悲君亦自悲	百年多是几多时	元稹					
遍身罗绮者	不是养蚕人	佚名					
寒夜客来茶当酒	杜爵						
寒波淡谈起	白鸟悠悠下	元遗山					
雄兔脚步朴朔	雌兔眼迷离		两兔傍地走	安能辨我是雄雌？佚名			
闲来无事不从容	睡觉东窗日已红	程颢					
闲来就写青山卖	不使人间造业钱	唐寅					
最是人间留不住	朱颜辞镜花辞树	王国维					
最恨多才情太浅。赵德麟							
等是有家归未得	杜鹃休向耳边啼！						
最是秋凤管闲情逸致事	红他枫叶白人头	赵翼					
最是仓皇辞庙日	教坊犹奏别离歌		挥泪对宫娥。李煜				
寻春须是先春早	看花莫待花枝老	李煜					
温柔乡是英雄家。马君武							
眷家不解淦家苦	好作寒流江钓雪图	孙承宗					
霎破月来花弄影。张先							
弃捐勿复道	努力加餐饭	佚名					
后恐匆匆说不尽	行人临行又开封	张籍					
童孙未解供耕织	也傍桑阴学种瓜	范成大					
萋萋芳草春云乱	愁在夕阳中	张可久					
著书都为稻梁谋。龚自珍							
寻常一样窗前月	才有梅花便不同		杜爵				
箭鸟欣有托	吾亦爱吾庐	陶渊明					
葡萄美酒光杯	欲饮琵琶马上催	王翰					
乡泪客中尽。孟浩然							
等闲识得东风页	万紫千红总是春	朱嘉					
晚饭少吃口	活到九十九	古乐府					
悲喜千般同幻梦	古今一梦尽荒唐	曹雪芹					
富贵必从勤音得	男儿须读五车书	杜甫					
富贵本无根	尽从勤里得		醒世恒言				
菩提本无树	明镜亦非台	慧能					
寻寻觅觅	冷冷清清		凄凄惨惨戚戚。李清照				
闲云潭影日悠悠	物换星称几度秋		王勃				
肇落惊风雨	诗成位鬼神	杜甫					
云想衣裳花相容。李白							
曾与情人桥上别	恨无消息到今朝	刘禹锡					
众里寻他千百度	蓦然回首		那人却在灯火阑珊处。辛弃疾				
